"filename", "language", "CMake", "CMake Cache", "comment", "blank", "total"
"/home/thb/Desktop/1_src/FISCO-BCOS/build/CMakeCache.txt", "CMake Cache", 0, 410, 0, 97, 507
"/home/thb/Desktop/1_src/FISCO-BCOS/build/CMakeFiles/3.19.1/CMakeCCompiler.cmake", "CMake", 60, 0, 0, 18, 78
"/home/thb/Desktop/1_src/FISCO-BCOS/build/CMakeFiles/3.19.1/CMakeCXXCompiler.cmake", "CMake", 70, 0, 0, 20, 90
"/home/thb/Desktop/1_src/FISCO-BCOS/build/CMakeFiles/3.19.1/CMakeSystem.cmake", "CMake", 10, 0, 0, 6, 16
"/home/thb/Desktop/1_src/FISCO-BCOS/build/CMakeFiles/BuildInfo.h.dir/DependInfo.cmake", "CMake", 9, 0, 0, 3, 12
"/home/thb/Desktop/1_src/FISCO-BCOS/build/CMakeFiles/BuildInfo.h.dir/cmake_clean.cmake", "CMake", 7, 0, 0, 2, 9
"/home/thb/Desktop/1_src/FISCO-BCOS/build/CMakeFiles/CMakeDirectoryInformation.cmake", "CMake", 12, 0, 0, 5, 17
"/home/thb/Desktop/1_src/FISCO-BCOS/build/CMakeFiles/GroupSigLib.dir/DependInfo.cmake", "CMake", 9, 0, 0, 3, 12
"/home/thb/Desktop/1_src/FISCO-BCOS/build/CMakeFiles/GroupSigLib.dir/cmake_clean.cmake", "CMake", 15, 0, 0, 2, 17
"/home/thb/Desktop/1_src/FISCO-BCOS/build/CMakeFiles/Makefile.cmake", "CMake", 324, 0, 0, 6, 330
"/home/thb/Desktop/1_src/FISCO-BCOS/build/CMakeFiles/boost.dir/DependInfo.cmake", "CMake", 9, 0, 0, 3, 12
"/home/thb/Desktop/1_src/FISCO-BCOS/build/CMakeFiles/boost.dir/cmake_clean.cmake", "CMake", 26, 0, 0, 2, 28
"/home/thb/Desktop/1_src/FISCO-BCOS/build/CMakeFiles/cryptopp.dir/DependInfo.cmake", "CMake", 9, 0, 0, 3, 12
"/home/thb/Desktop/1_src/FISCO-BCOS/build/CMakeFiles/cryptopp.dir/cmake_clean.cmake", "CMake", 16, 0, 0, 2, 18
"/home/thb/Desktop/1_src/FISCO-BCOS/build/CMakeFiles/evmc.dir/DependInfo.cmake", "CMake", 9, 0, 0, 3, 12
"/home/thb/Desktop/1_src/FISCO-BCOS/build/CMakeFiles/evmc.dir/cmake_clean.cmake", "CMake", 17, 0, 0, 2, 19
"/home/thb/Desktop/1_src/FISCO-BCOS/build/CMakeFiles/evmone.dir/DependInfo.cmake", "CMake", 9, 0, 0, 3, 12
"/home/thb/Desktop/1_src/FISCO-BCOS/build/CMakeFiles/evmone.dir/cmake_clean.cmake", "CMake", 16, 0, 0, 2, 18
"/home/thb/Desktop/1_src/FISCO-BCOS/build/CMakeFiles/gperftools.dir/DependInfo.cmake", "CMake", 9, 0, 0, 3, 12
"/home/thb/Desktop/1_src/FISCO-BCOS/build/CMakeFiles/gperftools.dir/cmake_clean.cmake", "CMake", 16, 0, 0, 2, 18
"/home/thb/Desktop/1_src/FISCO-BCOS/build/CMakeFiles/jsoncpp.dir/DependInfo.cmake", "CMake", 9, 0, 0, 3, 12
"/home/thb/Desktop/1_src/FISCO-BCOS/build/CMakeFiles/jsoncpp.dir/cmake_clean.cmake", "CMake", 16, 0, 0, 2, 18
"/home/thb/Desktop/1_src/FISCO-BCOS/build/CMakeFiles/jsonrpccpp.dir/DependInfo.cmake", "CMake", 9, 0, 0, 3, 12
"/home/thb/Desktop/1_src/FISCO-BCOS/build/CMakeFiles/jsonrpccpp.dir/cmake_clean.cmake", "CMake", 17, 0, 0, 2, 19
"/home/thb/Desktop/1_src/FISCO-BCOS/build/CMakeFiles/leveldb.dir/DependInfo.cmake", "CMake", 9, 0, 0, 3, 12
"/home/thb/Desktop/1_src/FISCO-BCOS/build/CMakeFiles/leveldb.dir/cmake_clean.cmake", "CMake", 16, 0, 0, 2, 18
"/home/thb/Desktop/1_src/FISCO-BCOS/build/CMakeFiles/libff.dir/DependInfo.cmake", "CMake", 9, 0, 0, 3, 12
"/home/thb/Desktop/1_src/FISCO-BCOS/build/CMakeFiles/libff.dir/cmake_clean.cmake", "CMake", 16, 0, 0, 2, 18
"/home/thb/Desktop/1_src/FISCO-BCOS/build/CMakeFiles/libvrf.dir/DependInfo.cmake", "CMake", 9, 0, 0, 3, 12
"/home/thb/Desktop/1_src/FISCO-BCOS/build/CMakeFiles/libvrf.dir/cmake_clean.cmake", "CMake", 15, 0, 0, 2, 17
"/home/thb/Desktop/1_src/FISCO-BCOS/build/CMakeFiles/libzdb.dir/DependInfo.cmake", "CMake", 9, 0, 0, 3, 12
"/home/thb/Desktop/1_src/FISCO-BCOS/build/CMakeFiles/libzdb.dir/cmake_clean.cmake", "CMake", 16, 0, 0, 2, 18
"/home/thb/Desktop/1_src/FISCO-BCOS/build/CMakeFiles/mhd.dir/DependInfo.cmake", "CMake", 9, 0, 0, 3, 12
"/home/thb/Desktop/1_src/FISCO-BCOS/build/CMakeFiles/mhd.dir/cmake_clean.cmake", "CMake", 16, 0, 0, 2, 18
"/home/thb/Desktop/1_src/FISCO-BCOS/build/CMakeFiles/mini-test.dir/DependInfo.cmake", "CMake", 55, 0, 0, 4, 59
"/home/thb/Desktop/1_src/FISCO-BCOS/build/CMakeFiles/mini-test.dir/cmake_clean.cmake", "CMake", 9, 0, 0, 2, 11
"/home/thb/Desktop/1_src/FISCO-BCOS/build/CMakeFiles/mpir.dir/DependInfo.cmake", "CMake", 9, 0, 0, 3, 12
"/home/thb/Desktop/1_src/FISCO-BCOS/build/CMakeFiles/mpir.dir/cmake_clean.cmake", "CMake", 16, 0, 0, 2, 18
"/home/thb/Desktop/1_src/FISCO-BCOS/build/CMakeFiles/mysqlclient.dir/DependInfo.cmake", "CMake", 9, 0, 0, 3, 12
"/home/thb/Desktop/1_src/FISCO-BCOS/build/CMakeFiles/mysqlclient.dir/cmake_clean.cmake", "CMake", 16, 0, 0, 2, 18
"/home/thb/Desktop/1_src/FISCO-BCOS/build/CMakeFiles/paillier.dir/DependInfo.cmake", "CMake", 9, 0, 0, 3, 12
"/home/thb/Desktop/1_src/FISCO-BCOS/build/CMakeFiles/paillier.dir/cmake_clean.cmake", "CMake", 15, 0, 0, 2, 17
"/home/thb/Desktop/1_src/FISCO-BCOS/build/CMakeFiles/rocksdb.dir/DependInfo.cmake", "CMake", 9, 0, 0, 3, 12
"/home/thb/Desktop/1_src/FISCO-BCOS/build/CMakeFiles/rocksdb.dir/cmake_clean.cmake", "CMake", 16, 0, 0, 2, 18
"/home/thb/Desktop/1_src/FISCO-BCOS/build/CMakeFiles/secp256k1.dir/DependInfo.cmake", "CMake", 9, 0, 0, 3, 12
"/home/thb/Desktop/1_src/FISCO-BCOS/build/CMakeFiles/secp256k1.dir/cmake_clean.cmake", "CMake", 16, 0, 0, 2, 18
"/home/thb/Desktop/1_src/FISCO-BCOS/build/CMakeFiles/snappy.dir/DependInfo.cmake", "CMake", 9, 0, 0, 3, 12
"/home/thb/Desktop/1_src/FISCO-BCOS/build/CMakeFiles/snappy.dir/cmake_clean.cmake", "CMake", 16, 0, 0, 2, 18
"/home/thb/Desktop/1_src/FISCO-BCOS/build/CMakeFiles/tassl.dir/DependInfo.cmake", "CMake", 9, 0, 0, 3, 12
"/home/thb/Desktop/1_src/FISCO-BCOS/build/CMakeFiles/tassl.dir/cmake_clean.cmake", "CMake", 15, 0, 0, 2, 17
"/home/thb/Desktop/1_src/FISCO-BCOS/build/CMakeFiles/tbb.dir/DependInfo.cmake", "CMake", 9, 0, 0, 3, 12
"/home/thb/Desktop/1_src/FISCO-BCOS/build/CMakeFiles/tbb.dir/cmake_clean.cmake", "CMake", 16, 0, 0, 2, 18
"/home/thb/Desktop/1_src/FISCO-BCOS/build/cmake_install.cmake", "CMake", 74, 0, 0, 11, 85
"/home/thb/Desktop/1_src/FISCO-BCOS/build/libblockchain/CMakeFiles/CMakeDirectoryInformation.cmake", "CMake", 12, 0, 0, 5, 17
"/home/thb/Desktop/1_src/FISCO-BCOS/build/libblockchain/CMakeFiles/blockchain.dir/DependInfo.cmake", "CMake", 34, 0, 0, 4, 38
"/home/thb/Desktop/1_src/FISCO-BCOS/build/libblockchain/CMakeFiles/blockchain.dir/cmake_clean.cmake", "CMake", 9, 0, 0, 2, 11
"/home/thb/Desktop/1_src/FISCO-BCOS/build/libblockchain/CMakeFiles/blockchain.dir/cmake_clean_target.cmake", "CMake", 3, 0, 0, 1, 4
"/home/thb/Desktop/1_src/FISCO-BCOS/build/libblockchain/cmake_install.cmake", "CMake", 37, 0, 0, 8, 45
"/home/thb/Desktop/1_src/FISCO-BCOS/build/libblockverifier/CMakeFiles/CMakeDirectoryInformation.cmake", "CMake", 12, 0, 0, 5, 17
"/home/thb/Desktop/1_src/FISCO-BCOS/build/libblockverifier/CMakeFiles/blockverifier.dir/DependInfo.cmake", "CMake", 37, 0, 0, 4, 41
"/home/thb/Desktop/1_src/FISCO-BCOS/build/libblockverifier/CMakeFiles/blockverifier.dir/cmake_clean.cmake", "CMake", 13, 0, 0, 2, 15
"/home/thb/Desktop/1_src/FISCO-BCOS/build/libblockverifier/CMakeFiles/blockverifier.dir/cmake_clean_target.cmake", "CMake", 3, 0, 0, 1, 4
"/home/thb/Desktop/1_src/FISCO-BCOS/build/libblockverifier/cmake_install.cmake", "CMake", 37, 0, 0, 8, 45
"/home/thb/Desktop/1_src/FISCO-BCOS/build/libchannelserver/CMakeFiles/CMakeDirectoryInformation.cmake", "CMake", 12, 0, 0, 5, 17
"/home/thb/Desktop/1_src/FISCO-BCOS/build/libchannelserver/CMakeFiles/channelserver.dir/DependInfo.cmake", "CMake", 55, 0, 0, 4, 59
"/home/thb/Desktop/1_src/FISCO-BCOS/build/libchannelserver/CMakeFiles/channelserver.dir/cmake_clean.cmake", "CMake", 11, 0, 0, 2, 13
"/home/thb/Desktop/1_src/FISCO-BCOS/build/libchannelserver/CMakeFiles/channelserver.dir/cmake_clean_target.cmake", "CMake", 3, 0, 0, 1, 4
"/home/thb/Desktop/1_src/FISCO-BCOS/build/libchannelserver/cmake_install.cmake", "CMake", 37, 0, 0, 8, 45
"/home/thb/Desktop/1_src/FISCO-BCOS/build/libconsensus/CMakeFiles/CMakeDirectoryInformation.cmake", "CMake", 12, 0, 0, 5, 17
"/home/thb/Desktop/1_src/FISCO-BCOS/build/libconsensus/CMakeFiles/consensus.dir/DependInfo.cmake", "CMake", 57, 0, 0, 4, 61
"/home/thb/Desktop/1_src/FISCO-BCOS/build/libconsensus/CMakeFiles/consensus.dir/cmake_clean.cmake", "CMake", 20, 0, 0, 2, 22
"/home/thb/Desktop/1_src/FISCO-BCOS/build/libconsensus/CMakeFiles/consensus.dir/cmake_clean_target.cmake", "CMake", 3, 0, 0, 1, 4
"/home/thb/Desktop/1_src/FISCO-BCOS/build/libconsensus/cmake_install.cmake", "CMake", 37, 0, 0, 8, 45
"/home/thb/Desktop/1_src/FISCO-BCOS/build/libdevcore/CMakeFiles/CMakeDirectoryInformation.cmake", "CMake", 12, 0, 0, 5, 17
"/home/thb/Desktop/1_src/FISCO-BCOS/build/libdevcore/CMakeFiles/devcore.dir/DependInfo.cmake", "CMake", 41, 0, 0, 4, 45
"/home/thb/Desktop/1_src/FISCO-BCOS/build/libdevcore/CMakeFiles/devcore.dir/cmake_clean.cmake", "CMake", 26, 0, 0, 2, 28
"/home/thb/Desktop/1_src/FISCO-BCOS/build/libdevcore/CMakeFiles/devcore.dir/cmake_clean_target.cmake", "CMake", 3, 0, 0, 1, 4
"/home/thb/Desktop/1_src/FISCO-BCOS/build/libdevcore/cmake_install.cmake", "CMake", 37, 0, 0, 8, 45
"/home/thb/Desktop/1_src/FISCO-BCOS/build/libdevcrypto/CMakeFiles/CMakeDirectoryInformation.cmake", "CMake", 12, 0, 0, 5, 17
"/home/thb/Desktop/1_src/FISCO-BCOS/build/libdevcrypto/CMakeFiles/devcrypto.dir/DependInfo.cmake", "CMake", 43, 0, 0, 4, 47
"/home/thb/Desktop/1_src/FISCO-BCOS/build/libdevcrypto/CMakeFiles/devcrypto.dir/cmake_clean.cmake", "CMake", 21, 0, 0, 2, 23
"/home/thb/Desktop/1_src/FISCO-BCOS/build/libdevcrypto/CMakeFiles/devcrypto.dir/cmake_clean_target.cmake", "CMake", 3, 0, 0, 1, 4
"/home/thb/Desktop/1_src/FISCO-BCOS/build/libdevcrypto/cmake_install.cmake", "CMake", 37, 0, 0, 8, 45
"/home/thb/Desktop/1_src/FISCO-BCOS/build/libethcore/CMakeFiles/CMakeDirectoryInformation.cmake", "CMake", 12, 0, 0, 5, 17
"/home/thb/Desktop/1_src/FISCO-BCOS/build/libethcore/CMakeFiles/ethcore.dir/DependInfo.cmake", "CMake", 40, 0, 0, 4, 44
"/home/thb/Desktop/1_src/FISCO-BCOS/build/libethcore/CMakeFiles/ethcore.dir/cmake_clean.cmake", "CMake", 22, 0, 0, 2, 24
"/home/thb/Desktop/1_src/FISCO-BCOS/build/libethcore/CMakeFiles/ethcore.dir/cmake_clean_target.cmake", "CMake", 3, 0, 0, 1, 4
"/home/thb/Desktop/1_src/FISCO-BCOS/build/libethcore/cmake_install.cmake", "CMake", 37, 0, 0, 8, 45
"/home/thb/Desktop/1_src/FISCO-BCOS/build/libeventfilter/CMakeFiles/CMakeDirectoryInformation.cmake", "CMake", 12, 0, 0, 5, 17
"/home/thb/Desktop/1_src/FISCO-BCOS/build/libeventfilter/CMakeFiles/eventfilter.dir/DependInfo.cmake", "CMake", 30, 0, 0, 4, 34
"/home/thb/Desktop/1_src/FISCO-BCOS/build/libeventfilter/CMakeFiles/eventfilter.dir/cmake_clean.cmake", "CMake", 11, 0, 0, 2, 13
"/home/thb/Desktop/1_src/FISCO-BCOS/build/libeventfilter/CMakeFiles/eventfilter.dir/cmake_clean_target.cmake", "CMake", 3, 0, 0, 1, 4
"/home/thb/Desktop/1_src/FISCO-BCOS/build/libeventfilter/cmake_install.cmake", "CMake", 37, 0, 0, 8, 45
"/home/thb/Desktop/1_src/FISCO-BCOS/build/libexecutive/CMakeFiles/CMakeDirectoryInformation.cmake", "CMake", 12, 0, 0, 5, 17
"/home/thb/Desktop/1_src/FISCO-BCOS/build/libexecutive/CMakeFiles/executivecontext.dir/DependInfo.cmake", "CMake", 37, 0, 0, 4, 41
"/home/thb/Desktop/1_src/FISCO-BCOS/build/libexecutive/CMakeFiles/executivecontext.dir/cmake_clean.cmake", "CMake", 13, 0, 0, 2, 15
"/home/thb/Desktop/1_src/FISCO-BCOS/build/libexecutive/CMakeFiles/executivecontext.dir/cmake_clean_target.cmake", "CMake", 3, 0, 0, 1, 4
"/home/thb/Desktop/1_src/FISCO-BCOS/build/libexecutive/cmake_install.cmake", "CMake", 37, 0, 0, 8, 45
"/home/thb/Desktop/1_src/FISCO-BCOS/build/libflowlimit/CMakeFiles/CMakeDirectoryInformation.cmake", "CMake", 12, 0, 0, 5, 17
"/home/thb/Desktop/1_src/FISCO-BCOS/build/libflowlimit/CMakeFiles/flowlimit.dir/DependInfo.cmake", "CMake", 26, 0, 0, 4, 30
"/home/thb/Desktop/1_src/FISCO-BCOS/build/libflowlimit/CMakeFiles/flowlimit.dir/cmake_clean.cmake", "CMake", 10, 0, 0, 2, 12
"/home/thb/Desktop/1_src/FISCO-BCOS/build/libflowlimit/CMakeFiles/flowlimit.dir/cmake_clean_target.cmake", "CMake", 3, 0, 0, 1, 4
"/home/thb/Desktop/1_src/FISCO-BCOS/build/libflowlimit/cmake_install.cmake", "CMake", 37, 0, 0, 8, 45
"/home/thb/Desktop/1_src/FISCO-BCOS/build/libinitializer/CMakeFiles/CMakeDirectoryInformation.cmake", "CMake", 12, 0, 0, 5, 17
"/home/thb/Desktop/1_src/FISCO-BCOS/build/libinitializer/CMakeFiles/initializer.dir/DependInfo.cmake", "CMake", 58, 0, 0, 4, 62
"/home/thb/Desktop/1_src/FISCO-BCOS/build/libinitializer/CMakeFiles/initializer.dir/cmake_clean.cmake", "CMake", 15, 0, 0, 2, 17
"/home/thb/Desktop/1_src/FISCO-BCOS/build/libinitializer/CMakeFiles/initializer.dir/cmake_clean_target.cmake", "CMake", 3, 0, 0, 1, 4
"/home/thb/Desktop/1_src/FISCO-BCOS/build/libinitializer/cmake_install.cmake", "CMake", 37, 0, 0, 8, 45
"/home/thb/Desktop/1_src/FISCO-BCOS/build/libledger/CMakeFiles/CMakeDirectoryInformation.cmake", "CMake", 12, 0, 0, 5, 17
"/home/thb/Desktop/1_src/FISCO-BCOS/build/libledger/CMakeFiles/ledger.dir/DependInfo.cmake", "CMake", 51, 0, 0, 4, 55
"/home/thb/Desktop/1_src/FISCO-BCOS/build/libledger/CMakeFiles/ledger.dir/cmake_clean.cmake", "CMake", 12, 0, 0, 2, 14
"/home/thb/Desktop/1_src/FISCO-BCOS/build/libledger/CMakeFiles/ledger.dir/cmake_clean_target.cmake", "CMake", 3, 0, 0, 1, 4
"/home/thb/Desktop/1_src/FISCO-BCOS/build/libledger/cmake_install.cmake", "CMake", 37, 0, 0, 8, 45
"/home/thb/Desktop/1_src/FISCO-BCOS/build/libmptstate/CMakeFiles/CMakeDirectoryInformation.cmake", "CMake", 12, 0, 0, 5, 17
"/home/thb/Desktop/1_src/FISCO-BCOS/build/libmptstate/CMakeFiles/mptstate.dir/DependInfo.cmake", "CMake", 39, 0, 0, 4, 43
"/home/thb/Desktop/1_src/FISCO-BCOS/build/libmptstate/CMakeFiles/mptstate.dir/cmake_clean.cmake", "CMake", 15, 0, 0, 2, 17
"/home/thb/Desktop/1_src/FISCO-BCOS/build/libmptstate/CMakeFiles/mptstate.dir/cmake_clean_target.cmake", "CMake", 3, 0, 0, 1, 4
"/home/thb/Desktop/1_src/FISCO-BCOS/build/libmptstate/cmake_install.cmake", "CMake", 37, 0, 0, 8, 45
"/home/thb/Desktop/1_src/FISCO-BCOS/build/libnetwork/CMakeFiles/CMakeDirectoryInformation.cmake", "CMake", 12, 0, 0, 5, 17
"/home/thb/Desktop/1_src/FISCO-BCOS/build/libnetwork/CMakeFiles/network.dir/DependInfo.cmake", "CMake", 31, 0, 0, 4, 35
"/home/thb/Desktop/1_src/FISCO-BCOS/build/libnetwork/CMakeFiles/network.dir/cmake_clean.cmake", "CMake", 13, 0, 0, 2, 15
"/home/thb/Desktop/1_src/FISCO-BCOS/build/libnetwork/CMakeFiles/network.dir/cmake_clean_target.cmake", "CMake", 3, 0, 0, 1, 4
"/home/thb/Desktop/1_src/FISCO-BCOS/build/libnetwork/cmake_install.cmake", "CMake", 37, 0, 0, 8, 45
"/home/thb/Desktop/1_src/FISCO-BCOS/build/libp2p/CMakeFiles/CMakeDirectoryInformation.cmake", "CMake", 12, 0, 0, 5, 17
"/home/thb/Desktop/1_src/FISCO-BCOS/build/libp2p/CMakeFiles/p2p.dir/DependInfo.cmake", "CMake", 33, 0, 0, 4, 37
"/home/thb/Desktop/1_src/FISCO-BCOS/build/libp2p/CMakeFiles/p2p.dir/cmake_clean.cmake", "CMake", 12, 0, 0, 2, 14
"/home/thb/Desktop/1_src/FISCO-BCOS/build/libp2p/CMakeFiles/p2p.dir/cmake_clean_target.cmake", "CMake", 3, 0, 0, 1, 4
"/home/thb/Desktop/1_src/FISCO-BCOS/build/libp2p/cmake_install.cmake", "CMake", 37, 0, 0, 8, 45
"/home/thb/Desktop/1_src/FISCO-BCOS/build/libplugin/CMakeFiles/CMakeDirectoryInformation.cmake", "CMake", 12, 0, 0, 5, 17
"/home/thb/Desktop/1_src/FISCO-BCOS/build/libplugin/CMakeFiles/plugin.dir/DependInfo.cmake", "CMake", 57, 0, 0, 4, 61
"/home/thb/Desktop/1_src/FISCO-BCOS/build/libplugin/CMakeFiles/plugin.dir/cmake_clean.cmake", "CMake", 12, 0, 0, 2, 14
"/home/thb/Desktop/1_src/FISCO-BCOS/build/libplugin/CMakeFiles/plugin.dir/cmake_clean_target.cmake", "CMake", 3, 0, 0, 1, 4
"/home/thb/Desktop/1_src/FISCO-BCOS/build/libplugin/cmake_install.cmake", "CMake", 37, 0, 0, 8, 45
"/home/thb/Desktop/1_src/FISCO-BCOS/build/libprecompiled/CMakeFiles/CMakeDirectoryInformation.cmake", "CMake", 12, 0, 0, 5, 17
"/home/thb/Desktop/1_src/FISCO-BCOS/build/libprecompiled/CMakeFiles/precompiled.dir/DependInfo.cmake", "CMake", 60, 0, 0, 4, 64
"/home/thb/Desktop/1_src/FISCO-BCOS/build/libprecompiled/CMakeFiles/precompiled.dir/cmake_clean.cmake", "CMake", 34, 0, 0, 2, 36
"/home/thb/Desktop/1_src/FISCO-BCOS/build/libprecompiled/CMakeFiles/precompiled.dir/cmake_clean_target.cmake", "CMake", 3, 0, 0, 1, 4
"/home/thb/Desktop/1_src/FISCO-BCOS/build/libprecompiled/cmake_install.cmake", "CMake", 41, 0, 0, 10, 51
"/home/thb/Desktop/1_src/FISCO-BCOS/build/libprecompiled/extension/CMakeFiles/CMakeDirectoryInformation.cmake", "CMake", 12, 0, 0, 5, 17
"/home/thb/Desktop/1_src/FISCO-BCOS/build/libprecompiled/extension/cmake_install.cmake", "CMake", 37, 0, 0, 8, 45
"/home/thb/Desktop/1_src/FISCO-BCOS/build/libprotobasic/CMakeFiles/CMakeDirectoryInformation.cmake", "CMake", 12, 0, 0, 5, 17
"/home/thb/Desktop/1_src/FISCO-BCOS/build/libprotobasic/CMakeFiles/protobasic.dir/DependInfo.cmake", "CMake", 20, 0, 0, 4, 24
"/home/thb/Desktop/1_src/FISCO-BCOS/build/libprotobasic/CMakeFiles/protobasic.dir/cmake_clean.cmake", "CMake", 9, 0, 0, 2, 11
"/home/thb/Desktop/1_src/FISCO-BCOS/build/libprotobasic/CMakeFiles/protobasic.dir/cmake_clean_target.cmake", "CMake", 3, 0, 0, 1, 4
"/home/thb/Desktop/1_src/FISCO-BCOS/build/libprotobasic/cmake_install.cmake", "CMake", 37, 0, 0, 8, 45
"/home/thb/Desktop/1_src/FISCO-BCOS/build/librpc/CMakeFiles/CMakeDirectoryInformation.cmake", "CMake", 12, 0, 0, 5, 17
"/home/thb/Desktop/1_src/FISCO-BCOS/build/librpc/CMakeFiles/rpc.dir/DependInfo.cmake", "CMake", 57, 0, 0, 4, 61
"/home/thb/Desktop/1_src/FISCO-BCOS/build/librpc/CMakeFiles/rpc.dir/cmake_clean.cmake", "CMake", 13, 0, 0, 2, 15
"/home/thb/Desktop/1_src/FISCO-BCOS/build/librpc/CMakeFiles/rpc.dir/cmake_clean_target.cmake", "CMake", 3, 0, 0, 1, 4
"/home/thb/Desktop/1_src/FISCO-BCOS/build/librpc/cmake_install.cmake", "CMake", 37, 0, 0, 8, 45
"/home/thb/Desktop/1_src/FISCO-BCOS/build/libsecurity/CMakeFiles/CMakeDirectoryInformation.cmake", "CMake", 12, 0, 0, 5, 17
"/home/thb/Desktop/1_src/FISCO-BCOS/build/libsecurity/CMakeFiles/security.dir/DependInfo.cmake", "CMake", 36, 0, 0, 4, 40
"/home/thb/Desktop/1_src/FISCO-BCOS/build/libsecurity/CMakeFiles/security.dir/cmake_clean.cmake", "CMake", 11, 0, 0, 2, 13
"/home/thb/Desktop/1_src/FISCO-BCOS/build/libsecurity/CMakeFiles/security.dir/cmake_clean_target.cmake", "CMake", 3, 0, 0, 1, 4
"/home/thb/Desktop/1_src/FISCO-BCOS/build/libsecurity/cmake_install.cmake", "CMake", 37, 0, 0, 8, 45
"/home/thb/Desktop/1_src/FISCO-BCOS/build/libstat/CMakeFiles/CMakeDirectoryInformation.cmake", "CMake", 12, 0, 0, 5, 17
"/home/thb/Desktop/1_src/FISCO-BCOS/build/libstat/CMakeFiles/stat.dir/DependInfo.cmake", "CMake", 26, 0, 0, 4, 30
"/home/thb/Desktop/1_src/FISCO-BCOS/build/libstat/CMakeFiles/stat.dir/cmake_clean.cmake", "CMake", 10, 0, 0, 2, 12
"/home/thb/Desktop/1_src/FISCO-BCOS/build/libstat/CMakeFiles/stat.dir/cmake_clean_target.cmake", "CMake", 3, 0, 0, 1, 4
"/home/thb/Desktop/1_src/FISCO-BCOS/build/libstat/cmake_install.cmake", "CMake", 37, 0, 0, 8, 45
"/home/thb/Desktop/1_src/FISCO-BCOS/build/libstorage/CMakeFiles/CMakeDirectoryInformation.cmake", "CMake", 12, 0, 0, 5, 17
"/home/thb/Desktop/1_src/FISCO-BCOS/build/libstorage/CMakeFiles/storage.dir/DependInfo.cmake", "CMake", 49, 0, 0, 4, 53
"/home/thb/Desktop/1_src/FISCO-BCOS/build/libstorage/CMakeFiles/storage.dir/cmake_clean.cmake", "CMake", 25, 0, 0, 2, 27
"/home/thb/Desktop/1_src/FISCO-BCOS/build/libstorage/CMakeFiles/storage.dir/cmake_clean_target.cmake", "CMake", 3, 0, 0, 1, 4
"/home/thb/Desktop/1_src/FISCO-BCOS/build/libstorage/cmake_install.cmake", "CMake", 37, 0, 0, 8, 45
"/home/thb/Desktop/1_src/FISCO-BCOS/build/libstoragestate/CMakeFiles/CMakeDirectoryInformation.cmake", "CMake", 12, 0, 0, 5, 17
"/home/thb/Desktop/1_src/FISCO-BCOS/build/libstoragestate/CMakeFiles/storagestate.dir/DependInfo.cmake", "CMake", 35, 0, 0, 4, 39
"/home/thb/Desktop/1_src/FISCO-BCOS/build/libstoragestate/CMakeFiles/storagestate.dir/cmake_clean.cmake", "CMake", 10, 0, 0, 2, 12
"/home/thb/Desktop/1_src/FISCO-BCOS/build/libstoragestate/CMakeFiles/storagestate.dir/cmake_clean_target.cmake", "CMake", 3, 0, 0, 1, 4
"/home/thb/Desktop/1_src/FISCO-BCOS/build/libstoragestate/cmake_install.cmake", "CMake", 37, 0, 0, 8, 45
"/home/thb/Desktop/1_src/FISCO-BCOS/build/libsync/CMakeFiles/CMakeDirectoryInformation.cmake", "CMake", 12, 0, 0, 5, 17
"/home/thb/Desktop/1_src/FISCO-BCOS/build/libsync/CMakeFiles/sync.dir/DependInfo.cmake", "CMake", 49, 0, 0, 4, 53
"/home/thb/Desktop/1_src/FISCO-BCOS/build/libsync/CMakeFiles/sync.dir/cmake_clean.cmake", "CMake", 19, 0, 0, 2, 21
"/home/thb/Desktop/1_src/FISCO-BCOS/build/libsync/CMakeFiles/sync.dir/cmake_clean_target.cmake", "CMake", 3, 0, 0, 1, 4
"/home/thb/Desktop/1_src/FISCO-BCOS/build/libsync/cmake_install.cmake", "CMake", 37, 0, 0, 8, 45
"/home/thb/Desktop/1_src/FISCO-BCOS/build/libtxpool/CMakeFiles/CMakeDirectoryInformation.cmake", "CMake", 12, 0, 0, 5, 17
"/home/thb/Desktop/1_src/FISCO-BCOS/build/libtxpool/CMakeFiles/txpool.dir/DependInfo.cmake", "CMake", 30, 0, 0, 4, 34
"/home/thb/Desktop/1_src/FISCO-BCOS/build/libtxpool/CMakeFiles/txpool.dir/cmake_clean.cmake", "CMake", 11, 0, 0, 2, 13
"/home/thb/Desktop/1_src/FISCO-BCOS/build/libtxpool/CMakeFiles/txpool.dir/cmake_clean_target.cmake", "CMake", 3, 0, 0, 1, 4
"/home/thb/Desktop/1_src/FISCO-BCOS/build/libtxpool/cmake_install.cmake", "CMake", 37, 0, 0, 8, 45
"/home/thb/Desktop/1_src/FISCO-BCOS/cmake/BuildInfo.cmake", "CMake", 61, 0, 0, 6, 67
"/home/thb/Desktop/1_src/FISCO-BCOS/cmake/CompilerSettings.cmake", "CMake", 148, 0, 0, 12, 160
"/home/thb/Desktop/1_src/FISCO-BCOS/cmake/Dependencies.cmake", "CMake", 52, 0, 0, 5, 57
"/home/thb/Desktop/1_src/FISCO-BCOS/cmake/Options.cmake", "CMake", 126, 0, 0, 24, 150
"/home/thb/Desktop/1_src/FISCO-BCOS/cmake/ProjectBoost.cmake", "CMake", 137, 0, 0, 20, 157
"/home/thb/Desktop/1_src/FISCO-BCOS/cmake/ProjectCryptopp.cmake", "CMake", 162, 0, 0, 4, 166
"/home/thb/Desktop/1_src/FISCO-BCOS/cmake/ProjectEVMC.cmake", "CMake", 34, 0, 0, 5, 39
"/home/thb/Desktop/1_src/FISCO-BCOS/cmake/ProjectEVMONE.cmake", "CMake", 32, 0, 0, 3, 35
"/home/thb/Desktop/1_src/FISCO-BCOS/cmake/ProjectGroupSig.cmake", "CMake", 52, 0, 0, 7, 59
"/home/thb/Desktop/1_src/FISCO-BCOS/cmake/ProjectJsonCpp.cmake", "CMake", 64, 0, 0, 4, 68
"/home/thb/Desktop/1_src/FISCO-BCOS/cmake/ProjectJsonRpcCpp.cmake", "CMake", 95, 0, 0, 9, 104
"/home/thb/Desktop/1_src/FISCO-BCOS/cmake/ProjectLevelDB.cmake", "CMake", 34, 0, 0, 7, 41
"/home/thb/Desktop/1_src/FISCO-BCOS/cmake/ProjectLibFF.cmake", "CMake", 44, 0, 0, 4, 48
"/home/thb/Desktop/1_src/FISCO-BCOS/cmake/ProjectLibzdb.cmake", "CMake", 53, 0, 0, 11, 64
"/home/thb/Desktop/1_src/FISCO-BCOS/cmake/ProjectMHD.cmake", "CMake", 29, 0, 0, 5, 34
"/home/thb/Desktop/1_src/FISCO-BCOS/cmake/ProjectMPIR.cmake", "CMake", 28, 0, 0, 4, 32
"/home/thb/Desktop/1_src/FISCO-BCOS/cmake/ProjectPaillier.cmake", "CMake", 25, 0, 0, 2, 27
"/home/thb/Desktop/1_src/FISCO-BCOS/cmake/ProjectRocksDB.cmake", "CMake", 52, 0, 0, 7, 59
"/home/thb/Desktop/1_src/FISCO-BCOS/cmake/ProjectSDF.cmake", "CMake", 59, 0, 0, 8, 67
"/home/thb/Desktop/1_src/FISCO-BCOS/cmake/ProjectSecp256k1.cmake", "CMake", 55, 0, 0, 4, 59
"/home/thb/Desktop/1_src/FISCO-BCOS/cmake/ProjectSnappy.cmake", "CMake", 33, 0, 0, 5, 38
"/home/thb/Desktop/1_src/FISCO-BCOS/cmake/ProjectTASSL.cmake", "CMake", 39, 0, 0, 5, 44
"/home/thb/Desktop/1_src/FISCO-BCOS/cmake/ProjectTBB.cmake", "CMake", 32, 0, 0, 5, 37
"/home/thb/Desktop/1_src/FISCO-BCOS/cmake/ProjectTCMalloc.cmake", "CMake", 34, 0, 0, 9, 43
"/home/thb/Desktop/1_src/FISCO-BCOS/cmake/ProjectVRF.cmake", "CMake", 54, 0, 0, 7, 61
"/home/thb/Desktop/1_src/FISCO-BCOS/cmake/UseOpenSSL.cmake", "CMake", 6, 0, 0, 1, 7
"/home/thb/Desktop/1_src/FISCO-BCOS/fisco-bcos/build/CMakeCache.txt", "CMake Cache", 0, 300, 0, 69, 369
"/home/thb/Desktop/1_src/FISCO-BCOS/fisco-bcos/build/CMakeFiles/3.21.1/CMakeCCompiler.cmake", "CMake", 63, 0, 0, 18, 81
"/home/thb/Desktop/1_src/FISCO-BCOS/fisco-bcos/build/CMakeFiles/3.21.1/CMakeCXXCompiler.cmake", "CMake", 72, 0, 0, 20, 92
"/home/thb/Desktop/1_src/FISCO-BCOS/fisco-bcos/build/CMakeFiles/3.21.1/CMakeSystem.cmake", "CMake", 10, 0, 0, 6, 16
"/home/thb/Desktop/1_src/FISCO-BCOS/fisco-bcos/build/CMakeFiles/CMakeDirectoryInformation.cmake", "CMake", 12, 0, 0, 5, 17
"/home/thb/Desktop/1_src/FISCO-BCOS/fisco-bcos/build/CMakeFiles/Makefile.cmake", "CMake", 48, 0, 0, 6, 54
"/home/thb/Desktop/1_src/FISCO-BCOS/fisco-bcos/build/cmake_install.cmake", "CMake", 46, 0, 0, 10, 56
"/home/thb/Desktop/1_src/FISCO-BCOS/fisco-bcos/build/main/CMakeFiles/CMakeDirectoryInformation.cmake", "CMake", 12, 0, 0, 5, 17
"/home/thb/Desktop/1_src/FISCO-BCOS/fisco-bcos/build/main/CMakeFiles/fisco-bcos.dir/DependInfo.cmake", "CMake", 14, 0, 0, 6, 20
"/home/thb/Desktop/1_src/FISCO-BCOS/fisco-bcos/build/main/CMakeFiles/fisco-bcos.dir/cmake_clean.cmake", "CMake", 10, 0, 0, 2, 12
"/home/thb/Desktop/1_src/FISCO-BCOS/fisco-bcos/build/main/cmake_install.cmake", "CMake", 42, 0, 0, 8, 50
"/home/thb/Desktop/1_src/FISCO-BCOS/fisco-bcos/para/CMakeCache.txt", "CMake Cache", 0, 303, 0, 69, 372
"/home/thb/Desktop/1_src/FISCO-BCOS/fisco-bcos/para/CMakeFiles/3.21.1/CMakeCCompiler.cmake", "CMake", 63, 0, 0, 18, 81
"/home/thb/Desktop/1_src/FISCO-BCOS/fisco-bcos/para/CMakeFiles/3.21.1/CMakeCXXCompiler.cmake", "CMake", 72, 0, 0, 20, 92
"/home/thb/Desktop/1_src/FISCO-BCOS/fisco-bcos/para/CMakeFiles/3.21.1/CMakeSystem.cmake", "CMake", 10, 0, 0, 6, 16
"/home/thb/Desktop/1_src/FISCO-BCOS/fisco-bcos/para/CMakeFiles/CMakeDirectoryInformation.cmake", "CMake", 12, 0, 0, 5, 17
"/home/thb/Desktop/1_src/FISCO-BCOS/fisco-bcos/para/CMakeFiles/Makefile.cmake", "CMake", 123, 0, 0, 6, 129
"/home/thb/Desktop/1_src/FISCO-BCOS/fisco-bcos/para/cmake_install.cmake", "CMake", 46, 0, 0, 10, 56
"/home/thb/Desktop/1_src/FISCO-BCOS/fisco-bcos/para/main/CMakeFiles/CMakeDirectoryInformation.cmake", "CMake", 12, 0, 0, 5, 17
"/home/thb/Desktop/1_src/FISCO-BCOS/fisco-bcos/para/main/CMakeFiles/fisco-bcos.dir/DependInfo.cmake", "CMake", 14, 0, 0, 6, 20
"/home/thb/Desktop/1_src/FISCO-BCOS/fisco-bcos/para/main/CMakeFiles/fisco-bcos.dir/cmake_clean.cmake", "CMake", 10, 0, 0, 2, 12
"/home/thb/Desktop/1_src/FISCO-BCOS/fisco-bcos/para/main/cmake_install.cmake", "CMake", 42, 0, 0, 8, 50
"/home/thb/Desktop/1_src/FISCO-BCOS/fisco-bcos/sync/CMakeCache.txt", "CMake Cache", 0, 303, 0, 69, 372
"/home/thb/Desktop/1_src/FISCO-BCOS/fisco-bcos/sync/CMakeFiles/3.21.1/CMakeCCompiler.cmake", "CMake", 63, 0, 0, 18, 81
"/home/thb/Desktop/1_src/FISCO-BCOS/fisco-bcos/sync/CMakeFiles/3.21.1/CMakeCXXCompiler.cmake", "CMake", 72, 0, 0, 20, 92
"/home/thb/Desktop/1_src/FISCO-BCOS/fisco-bcos/sync/CMakeFiles/3.21.1/CMakeSystem.cmake", "CMake", 10, 0, 0, 6, 16
"/home/thb/Desktop/1_src/FISCO-BCOS/fisco-bcos/sync/CMakeFiles/CMakeDirectoryInformation.cmake", "CMake", 12, 0, 0, 5, 17
"/home/thb/Desktop/1_src/FISCO-BCOS/fisco-bcos/sync/CMakeFiles/Makefile.cmake", "CMake", 48, 0, 0, 6, 54
"/home/thb/Desktop/1_src/FISCO-BCOS/fisco-bcos/sync/cmake_install.cmake", "CMake", 46, 0, 0, 10, 56
"/home/thb/Desktop/1_src/FISCO-BCOS/fisco-bcos/sync/main/CMakeFiles/CMakeDirectoryInformation.cmake", "CMake", 12, 0, 0, 5, 17
"/home/thb/Desktop/1_src/FISCO-BCOS/fisco-bcos/sync/main/CMakeFiles/fisco-bcos.dir/DependInfo.cmake", "CMake", 14, 0, 0, 6, 20
"/home/thb/Desktop/1_src/FISCO-BCOS/fisco-bcos/sync/main/CMakeFiles/fisco-bcos.dir/cmake_clean.cmake", "CMake", 10, 0, 0, 2, 12
"/home/thb/Desktop/1_src/FISCO-BCOS/fisco-bcos/sync/main/cmake_install.cmake", "CMake", 42, 0, 0, 8, 50
"Total", "-", 6526, 1316, 0, 1442, 9284